10 10
L L L T C T T T C T
T L L T C T T T C T
T L L T C T T T C T
T T T T C C C C C C
T C C C C T T T C T
T C T T C T L T C T
T C T T C T L T C T
T C T T C T T T C T
C C C C C C C C C C
T C T T C T T T C T