8 10
L L L L T T C C T T
T L L L T T C C T T
T L L T T T C C T T
T T T T C C C C C C
T C C C C T T T C T
T C T T C T L T C T
T C T T C T L T C T
T C C C C C C C C C